Sy's Ultimate Mix 1 file listing
Email me at Ultimate.Mix.1@tanstaafl.com.au
Data gathered on Mon Aug  2 06:00:02 WST 2010

Eric Prydz - Call On Me
Studio B - I See Girls
Urban Cookie Collective - The Key, The Secret
Darude - Sandstorm
Camisra - Let Me Show You (Tall Paul Remix)
Public Domain - Operation Blade (Original Mix)
The Chemical Brothers - Block Rockin' Beats
Fluke - Absurd
MVP - Roc Ya Body (Mic Check 1, 2)
The Potbelleez - Don't Hold Back (Original Mix)
Underworld - Born Slippy .NUXX
StoneBridge featuring Therese - Put 'Em High (JJ's Radio Edit)
Slinkee Minx - Summer Rain (Alex K Mix)
Bomb The Bass - Megablast (Hip Hop on Precinct 13) (7' Mix)
Dragula - Hot Rod (Herman Mix)
Who Da Funk featuring Jessica Eve - Shiny Disco Balls (Main Mix)
Snap! - Rhythm Is A Dancer
Armin Van Buuren - Face to Face
Boogie Pimps - Somebody To Love
Oakenfold - Ready Steady Go
The Prodigy - Smack My Bitch Up
XTM & DJ Chucky featuring Annia - Fly On The Wings Of Love
Ian Van Dahl - Castles In The Sky
4 Strings - Diving
Tomcraft - Loneliness
ATB - 9pm (Till I Come) (Radio Edit)
Unknown - Unknown
Prodigy - Out Of Space
Black Box - Ride On Time
Faithless - Insomnia (Monster Radio Edit)
Darude - Feel the Beat
Utah Saints - Something Good '08 (Radio Edit)
Faithless - God Is A DJ (Monster Mix)
The Shamen - Ebeneezer Goode
Tiesto - Adagio for Strings (Radio Edit)
The Chemical Brothers - Out of Control
Uniting Nations - Out Of Touch
DJ Sammy & Yanou featuring Do - Heaven
Felix - Don't You Want Me
Binary Finary - 1999 (Gouryella Remix)
Baby D - Let Me Be Your Fantasy
Sneaker Pimps - Spin Spin Sugar (Armands Dark Garage Mix)
Daft Punk - One More Time
Roger Sanchez - Another Chance
Moby - The Matrix (Lobby Scene)
The Chemical Brothers - Hey Boy Hey Girl
Kylie Minogue vs New Order - Can't Get Blue Monday Out Of My Head
The KLF - 3am Eternal
iiO - Rapture (Tastes So Sweet) (Radio Edit)
Brainbug - Nightmare
Shapeshifters - Lola's Theme
Rozalla - Everybody's Free (To Feel Good)
Robert Miles - Children
